####################
#---...-----...----#
#-$-@---####--$----#
##---###---###-$-###
-##--#-------#---#--
--#-$#-------##-$#--
--#--#--------#--#--
--#-$#--------#--#--
--#--#--------####--
--####--------------


ans:
lddddrUUlddddrUUluuuurrllulldRdrUluRRRdrrudllllddrUUluRdddlddrUUUUrrrurrrrrdrurrrdddlddrUUUUddlluUruLLrrdrdLdlUUruLrldrrruLL